а --> н
б --> ч
в --> б
г --> л
д --> о
е --> а
ж --> щ
з --> е
и --> я
к --> в
л --> с
м --> ф
н --> у
о --> ь
п --> ж
р --> э
с --> м
т --> т
у --> х
ф --> г
х --> д
ц --> ц
ч --> ш
ш --> к
щ --> п
ы --> ю
ь --> ы
э --> р
ю --> и
я --> з
[] --> ъ
